++++++++++++
+     +++T++
++     ++ ++
++ +  ++   +
+++ +  +++ +
+++ +++ ++ +
+    S     +
++++  +++  +
++++   ++  +
++ +   ++ ++
+ ++  +++  +
+ ++  ++ + +
+ +++       
+ +++  + +++
++      T+++
++++++++++++