++++++++++++++++++++++
+ T +   ++ ++        +
      +     ++++++++++
+ +    ++  ++++ +++ ++
+ +   + + ++    +++  +
+          ++  ++  + +
+     + +      ++  + +
+++++ +++  + +  ++   +
++++       + + S+ +  +
+++++ + T+ + +     + +
++++++++++++++++++++++