+++++++++++++++++++++++++++++++++++++++++++++++++++++++++++++++++++++   +
+ S +               +               +           +                   +   +
+   +   +++++++++   +   +++++   +++++++++   +++++   +++++   +++++   +   +
+               +       +   +           +           +   +   +       +   +
+++++++++   +   +++++++++   +++++++++   +++++   +   +   +   +++++++++   +
+       +   +         T     +           +   +   +   +   +           +   +
+   +   +++++++++++++   +   +   +++++++++   +++++   +   +++++++++   +   +
+   +               +   +   +       +           +           +       +   +
+   +++++++++++++   +++++   +++++   +   +++++   +++++++++   +   +++++   +
+           +       +   +       +   +       +           +   +           +
+   +++++   +++++   +   +++++   +   +++++++++   +   +   +   +++++++++++++
+       +       +   +   +       +       +       +   +   +       +       +
+++++++++++++   +   +   +   +++++++++   +   +++++   +   +++++   +++++   +
+           +   +     T     +       +   +       +   +       +           +
+   +++++   +   +++++++++   +++++   +   +++++   +++++   +++++++++++++   +
+   +       +           +           +       +   +   +               +   +
+   +   +++++++++   +   +++++   +++++++++   +   +   +++++++++++++   +   +
+   +           +   +   +   +   +           +               +   +       +
+   +++++++++   +   +   +   +++++   +++++++++   +++++++++   +   +++++++++
+   +       +   +   +           +           +   +       +               +
+   +   +++++   +++++   +++++   +++++++++   +++++   +   +++++++++   +   +
+   +                   +           +               +               +   +
+   +++++++++++++++++++++++++++++++++++++++++++++++++++++++++++++++++++++